#tileset
tilesetIPMON.bmp
8 5
tile0: noncollision
tile1: noncollision
tile2: noncollision
tile3: noncollision
tile4: collision
tile5: collision
tile6: collision
tile7: collision
tile8: collision
tile9: collision
tile10: collision
tile11: collision
tile12: collision
tile13: collision
tile14: collision
tile15: collision
tile16: collision
tile17: collision
tile18: collision
tile19: collision
tile20: collision
tile21: collision
tile22: collision
tile23: collision
tile24: collision
tile25: collision
tile26: collision
tile27: collision
tile28: collision
tile29: collision
tile30: collision
tile31: collision
tile32: collision
tile33: collision
tile34: collision
tile35: collision
tile36: collision
tile37: collision
tile38: collision
tile39: collision
#level
24 24
1 	1 	1 	1 	1 	1 	1 	1 	1 	1 	1 	1 	1 	1 	1 	1 	1 	1 	1 	1 	1 	1 	1 	1 	
1 	1 	1 	1 	1 	1 	1 	1 	1 	1 	1 	1 	1 	1 	1 	1 	1 	1 	1 	1 	1 	1 	1 	1 	
1 	1 	1 	1 	1 	1 	1 	1 	4 	5 	6 	7 	1 	1 	1 	0 	0 	0 	0 	1 	0 	1 	0 	1 	
1 	1 	1 	1 	1 	1 	1 	1 	12 	13 	14 	15 	1 	1 	1 	0 	1 	1 	0 	1 	0 	0 	0 	1 	
1 	1 	1 	1 	1 	1 	1 	1 	20 	21 	22 	23 	1 	1 	1 	0 	1 	1 	0 	1 	0 	1 	0 	1 	
1 	1 	1 	1 	1 	1 	1 	1 	1 	29 	30 	1 	1 	1 	1 	0 	0 	0 	0 	1 	0 	1 	0 	1 	
1 	1 	1 	1 	1 	1 	1 	1 	1 	0 	0 	1 	1 	1 	1 	1 	1 	1 	1 	1 	1 	1 	1 	1 	
1 	1 	1 	1 	1 	1 	1 	1 	1 	0 	0 	1 	1 	1 	1 	1 	1 	1 	1 	1 	1 	1 	1 	1 	
1 	1 	1 	1 	1 	1 	1 	1 	1 	0 	0 	1 	1 	1 	1 	1 	1 	1 	0 	1 	1 	1 	1 	1 	
1 	1 	1 	1 	0 	1 	1 	1 	1 	0 	0 	1 	1 	1 	1 	1 	1 	0 	0 	1 	1 	1 	1 	1 	
1 	1 	1 	1 	0 	1 	1 	1 	1 	0 	0 	1 	1 	1 	1 	1 	0 	0 	0 	1 	1 	1 	1 	1 	
1 	1 	1 	1 	0 	0 	1 	1 	1 	0 	0 	1 	1 	1 	0 	0 	0 	1 	0 	1 	1 	1 	1 	1 	
1 	1 	1 	1 	0 	0 	0 	1 	1 	0 	0 	1 	1 	1 	0 	1 	1 	1 	0 	1 	1 	1 	1 	1 	
1 	1 	1 	0 	0 	1 	0 	1 	1 	0 	0 	1 	0 	0 	1 	1 	1 	1 	0 	1 	1 	1 	1 	1 	
1 	1 	1 	0 	1 	1 	1 	0 	0 	0 	0 	0 	0 	1 	1 	1 	1 	1 	0 	1 	1 	1 	1 	1 	
1 	1 	1 	0 	1 	1 	1 	1 	0 	0 	0 	0 	1 	1 	1 	1 	1 	1 	0 	1 	1 	1 	1 	1 	
0 	0 	0 	0 	0 	0 	0 	0 	0 	0 	0 	0 	0 	0 	0 	0 	0 	0 	0 	0 	0 	0 	0 	0 	
0 	0 	0 	0 	0 	0 	0 	0 	0 	0 	0 	0 	0 	0 	0 	0 	0 	0 	0 	0 	0 	0 	0 	0 	
1 	1 	1 	1 	1 	1 	1 	1 	1 	0 	0 	1 	1 	1 	1 	1 	1 	1 	1 	1 	1 	1 	1 	1 	
1 	1 	1 	1 	1 	1 	1 	1 	1 	0 	0 	1 	1 	1 	1 	1 	1 	1 	1 	1 	1 	1 	1 	1 	
1 	1 	1 	1 	1 	1 	1 	1 	1 	0 	0 	1 	1 	1 	1 	1 	1 	1 	1 	1 	1 	1 	1 	1 	
1 	1 	1 	1 	1 	1 	1 	1 	1 	0 	0 	1 	1 	1 	1 	1 	1 	1 	1 	1 	1 	1 	1 	1 	
1 	1 	1 	1 	1 	1 	1 	1 	1 	1 	1 	1 	1 	1 	1 	1 	1 	1 	1 	1 	1 	1 	1 	1 	
1 	1 	1 	1 	1 	1 	1 	1 	1 	1 	1 	1 	1 	1 	1 	1 	1 	1 	1 	1 	1 	1 	1 	1 	
